NO ./texture/wall_4.xpm
SO ./texture/wall_3.xpm
WE ./texture/wall_2.xpm
EA ./texture/wall_1.xpm

C 134,255,247
F 24,100,171


11111
11001
1100
11001
110N1
11111

