NO ./path_to_the_north_texture
SO ./path_to_the_south_texture
WE ./path_to_the_west_texture
EA ./path_to_the_east_texture

C 134,0159,247
F 24,100,171


1111100000000111111111111
1000000000110000000000001
10110000011100E00000000001
1001000000000000000000001
1111111110110000011100000000000011
100000000011000001110111111111111
10000000000000001101010010001


11000001110101011111011110111
11110111 1110101 101111010001
11111111 1111111 11111111111111111111111



