NO ./path_to_the_north_texture
SO ./path_to_the_south_texture
WE ./path_to_the_west_texture
EA ./path_to_the_east_texture

C 134,0159,247
F 24,100,171


11 11
1N11
1111
111
1

1111
1011

