NO ./texture/wall_4.xpm
SO ./texture/wall_3.xpm
WE ./texture/wall_2.xpm
EA ./texture/wall_1.xpm

C 255,255,255
F 000,000,000


1111111111111111111111111
1N00000000110000000000001
1011000001110000000000001
1001000000000000000000001
111111111011000001110000111111111
100000000011000001110111111111111
1111111111111111111111111


11111111111111111111111111111
11110111 1110101 101111010001
11111111 1111111 111111111111

