NO ./path_to_the_north_texture
SO ./path_to_the_south_texture
WE ./path_to_the_west_texture
EA ./path_to_the_east_texture

C 114,159,254
F 24,100,134


1 11
1111
1N00111111
1111
111111111